
ya	an asian pear [n -s]
yaar	"(hinglish) friend, man (as a form of address) [n -s]"
yaars	"yaar, (hinglish) friend, man (as a form of address) [n]"
yaba	(colloquial) yet another bloody acronym [n -s]
yabas	"yaba, (colloquial) yet another bloody acronym [n]"
yabba	"a methamphetamine, a stimulant drug [n -s]"
yabbas	"yabba, a methamphetamine, a stimulant drug [n]"
yabber	"(native australian) to talk [v -ed, -ing, -s]"
yabbered	"yabber, (native australian) to talk [v]"
yabbering	"yabber, (native australian) to talk [v]"
yabbers	"yabber, (native australian) to talk [v]"
yabbie	"a small freshwater crayfish, also yabby [n -s] / to fish for yabbies [v yabbied, yabbying, yabbies]"
yabbied	"yabby, to catch yabbies, also yabbie [v]"
yabbies	"yabby, to catch yabbies, also yabbie [v]"
yabby	"(native australian) a small freshwater crayfish [n yabbies] / to catch yabbies, also yabbie [v yabbied, yabbying, yabbies]"
yabbying	"yabby, to catch yabbies, also yabbie [v]"
yacca	"(australian slang) an australian plant with a woody stem and stiff grasslike leaves, aka grass tree [n -s]"
yaccas	"yacca, (australian slang) an australian plant with a woody stem and stiff grasslike leaves, aka grass tree [n]"
yacht	"a vessel propelled by sail or power, used esp. for pleasure cruising, racing, etc. [n -s] / to sail or cruise in a yacht [v -ed, -ing, -s]"
yachted	"yacht, to sail or cruise in a yacht [v]"
yachter	"one who sails a yacht, also yachtie, yachtman, yachtsman [n -s]"
yachters	"yachter, one who sails a yacht, also yachtie, yachtman, yachtsman [n]"
yachtie	"(australian slang) a yachtsman, also yachter, yachtman, yachtsman [n -s]"
yachties	"yachtie, (australian slang) a yachtsman, also yachter, yachtman, yachtsman [n]"
yachting	the sport of sailing or cruising in a yacht [n -s]
yachtings	"yachting, the sport of sailing or cruising in a yacht [n]"
yachtman	"one who sails a yacht, also yachter, yachtie, yachtsman [n yachtmen]"
yachtmen	"yachtman, one who sails a yacht, also yachter, yachtie, yachtsman [n]"
yachts	"yacht, to sail or cruise in a yacht [v]"
yachtsman	"one who sails a yacht, also yachter, yachtie, yachtman [n yachtsmen]"
yachtsmanship	the art of sailing a yacht [n -s]
yachtsmanships	"yachtsmanship, the art of sailing a yacht [n]"
yachtsmen	"yachtsman, one who sails a yacht, also yachter, yachtie, yachtman [n]"
yachtswoman	a woman who sails a yacht [n yachtswomen]
yachtswomen	"yachtswoman, a woman who sails a yacht [n]"
yack	"to talk persistently, also yak [v -ed, -ing, -s]"
yacka	"(australian slang) an australian plant with a woody stem and stiff grasslike leaves, aka grass tree [n -s]"
yackas	"yacka, (australian slang) an australian plant with a woody stem and stiff grasslike leaves, aka grass tree [n]"
yacked	"yack, to talk persistently, also yak [v]"
yacker	"(native australian) hard work, toil, also yakka, yakker [n -s]"
yackers	"yacker, (native australian) hard work, toil, also yakka, yakker [n]"
yacking	"yack, to talk persistently, also yak [v]"
yacks	"yack, to talk persistently, also yak [v]"
yad	(hebrew) a handheld pointer used for reading the torah [n -s]
yads	"yad, (hebrew) a handheld pointer used for reading the torah [n]"
yae	"(scots) one, also ae [adj]"
yaff	"(scots) to bark, scold, nag, also nyaff [v -ed, -ing, -s]"
yaffed	"yaff, (scots) to bark, scold, nag, also nyaff [v]"
yaffing	"yaff, (scots) to bark, scold, nag, also nyaff [v]"
yaffingale	the yaffle or green woodpecker [n -s]
yaffingales	"yaffingale, the yaffle or green woodpecker [n]"
yaffle	the green woodpecker [n -s]
yaffles	"yaffle, the green woodpecker [n]"
yaffs	"yaff, (scots) to bark, scold, nag, also nyaff [v]"
yag	"a type of synthetic garnet containing yttrium and aluminium, used in lasers and as a gem [n -s]"
yage	"a tropical vine of the amazon region, aka ayahuasca [n -s]"
yager	"(german) a huntsman, also jaeger, jager [n -s]"
yagers	"yager, (german) a huntsman, also jaeger, jager [n]"
yages	"yage, a tropical vine of the amazon region, aka ayahuasca [n]"
yagger	(scots) a pedlar [n -s]
yaggers	"yagger, (scots) a pedlar [n]"
yagi	(japanese) a type of shortwave antenna [n -s]
yagis	"yagi, (japanese) a type of shortwave antenna [n]"
yags	"yag, a type of synthetic garnet containing yttrium and aluminium, used in lasers and as a gem [n]"
yah	an affected upper-class person [n -s]
yahoo	"in cricket, an exuberant attempt to hit the ball hard, often with disappointing results [n -s]"
yahooism	uncouth behaviour [n -s]
yahooisms	"yahooism, uncouth behaviour [n]"
yahoos	"yahoo, in cricket, an exuberant attempt to hit the ball hard, often with disappointing results [n]"
yahrzeit	(yiddish) an anniversary of the death of a family member observed by jews [n -s]
yahrzeits	"yahrzeit, (yiddish) an anniversary of the death of a family member observed by jews [n]"
yahs	"yah, an affected upper-class person [n]"
yaird	"a yard, a garden [n -s]"
yairds	"yaird, a yard, a garden [n]"
yak	"to talk persistently, also yack [v yakked, yakking, yaks]"
yakhdan	(persian) a box used for carrying ice on the back of a pack animal [n -s]
yakhdans	"yakhdan, (persian) a box used for carrying ice on the back of a pack animal [n]"
yakimono	"(japanese) in japanese cookery, grilled food, a grilled dish [n -s]"
yakimonos	"yakimono, (japanese) in japanese cookery, grilled food, a grilled dish [n]"
yakitori	(japanese) bitesize marinated chicken on small skewers [n -s]
yakitoris	"yakitori, (japanese) bitesize marinated chicken on small skewers [n]"
yakka	"(native australian) hard work, toil, also yacker, yakker [n -s]"
yakkas	"yakka, (native australian) hard work, toil, also yacker, yakker [n]"
yakked	"yak, to talk persistently, also yack [v]"
yakker	"(native australian) hard work, toil, also yacker, yakka [n -s]"
yakkers	"yakker, (native australian) hard work, toil, also yacker, yakka [n]"
yakking	"yak, to talk persistently, also yack [v]"
yakow	an animal crossbred from a male yak and a domestic cow [n -s]
yakows	"yakow, an animal crossbred from a male yak and a domestic cow [n]"
yaks	"yak, to talk persistently, also yack [v]"
yakuza	(japanese) a japanese gangster [n yakuza]
yald	"(scots) active, nimble, also yauld [adj]"
yale	a fabulous heraldic beast [n -s]
yales	"yale, a fabulous heraldic beast [n]"
yam	a sweet potato [n -s]
yamalka	"(yiddish) a religious skullcap, also yamulka, yarmelke, yarmulka, yarmulke [n -s]"
yamalkas	"yamalka, (yiddish) a religious skullcap, also yamulka, yarmelke, yarmulka, yarmulke [n]"
yamen	"(chinese) the offices and residence of a mandarin, also yamun [n -s]"
yamens	"yamen, (chinese) the offices and residence of a mandarin, also yamun [n]"
yammer	"to complain peevishly; to howl [v -ed, -ing, -s]"
yammered	"yammer, to complain peevishly; to howl [v]"
yammerer	one who yammers [n -s]
yammerers	"yammerer, one who yammers [n]"
yammering	peevish complaint [n -s]
yammerings	"yammering, peevish complaint [n]"
yammers	"yammer, to complain peevishly; to howl [v]"
yampies	"yampy, (dialect) a foolish person [n]"
yampy	(dialect) a foolish person [n yampies]
yams	"yam, a sweet potato [n]"
yamulka	"(yiddish) a religious skullcap, also yamalka, yarmelke, yarmulka, yarmulke [n -s]"
yamulkas	"yamulka, (yiddish) a religious skullcap, also yamalka, yarmelke, yarmulka, yarmulke [n]"
yamun	"(chinese) the offices and residence of a mandarin, also yamen [n -s]"
yamuns	"yamun, (chinese) the offices and residence of a mandarin, also yamen [n]"
yang	(chinese) a species of thai timber tree [n -s]
yangs	"yang, (chinese) a species of thai timber tree [n]"
yank	"to pull with a jerk [v -ed, -ing, -s]"
yanked	"yank, to pull with a jerk [v]"
yankee	(in international radio communication) a code word for the letter y [n -s]
yankees	"yankee, (in international radio communication) a code word for the letter y [n]"
yanker	(scots) a big lie [n -s]
yankers	"yanker, (scots) a big lie [n]"
yankie	(scots) a scold; an impudent woman [n -s]
yankies	"yankie, (scots) a scold; an impudent woman [n]"
yanking	"yank, to pull with a jerk [v]"
yanks	"yank, to pull with a jerk [v]"
yanqui	"(spanish) in latin america, a north american [n -s]"
yanquis	"yanqui, (spanish) in latin america, a north american [n]"
yantra	(sanskrit) a geometrical diagram used in meditation [n -s]
yantras	"yantra, (sanskrit) a geometrical diagram used in meditation [n]"
yaourt	"a semisolid, somewhat sour foodstuff, made from milk curdled by the addition of certain bacteria, also yoghourt, yoghurt, yogourt, yogurt [n -s]"
yaourts	"yaourt, a semisolid, somewhat sour foodstuff, made from milk curdled by the addition of certain bacteria, also yoghourt, yoghurt, yogourt, yogurt [n]"
yap	"to bark shrilly [v yapped, yapping, yaps]"
yapock	"the south american opossum, also yapok [n -s]"
yapocks	"yapock, the south american opossum, also yapok [n]"
yapok	"the south american opossum, also yapock [n -s]"
yapoks	"yapok, the south american opossum, also yapock [n]"
yapon	"a bushy evergreen shrub of the holly genus, also yaupon, youpon, yupon [n -s]"
yapons	"yapon, a bushy evergreen shrub of the holly genus, also yaupon, youpon, yupon [n]"
yapp	a limp leather binding [n -s]
yapped	"yap, to bark shrilly [v]"
yapper	a yappy dog [n -s]
yappers	"yapper, a yappy dog [n]"
yappie	"a young aspiring professional; a young affluent parent, also yappy [n -s]"
yappier	"yappy, given to yapping [adj]"
yappies	"yappie, a young aspiring professional; a young affluent parent, also yappy [n]"
yappiest	"yappy, given to yapping [adj]"
yapping	a high-pitched barking [n -s]
yappingly	yapping [adv]
yappings	"yapping, a high-pitched barking [n]"
yapps	"yapp, a limp leather binding [n]"
yappy	"given to yapping [adj yappier, yappiest] / a young aspiring professional; a young affluent parent, also yappie [n yappies]"
yaps	"yap, to bark shrilly [v]"
yapster	a dog [n -s]
yapsters	"yapster, a dog [n]"
yaqona	"(fijian) a shrub, of the west pacific islands, aka kava; a narcotic fermented drink made esp. in fiji from its macerated roots [n -s]"
yaqonas	"yaqona, (fijian) a shrub, of the west pacific islands, aka kava; a narcotic fermented drink made esp. in fiji from its macerated roots [n]"
yar	"nimble, also yare [adj yarer, yarest]"
yarak	"(persian) of a hawk, a fit condition for hunting [n -s]"
yaraks	"yarak, (persian) of a hawk, a fit condition for hunting [n]"
yarborough	a type of hand at bridge [n -s]
yarboroughs	"yarborough, a type of hand at bridge [n]"
yarco	(australian slang) a young working-class person who wears casual sports clothes [n -s]
yarcos	"yarco, (australian slang) a young working-class person who wears casual sports clothes [n]"
yard	"an enclosed place, esp. near a building [n -s] / to enclose in a yard, also yaird [v -ed, -ing, -s]"
yardage	the use of an enclosure for livestock at a railway station [n -s]
yardages	"yardage, the use of an enclosure for livestock at a railway station [n]"
yardang	(turkish) a ridge formed by wind erosion parallel to prevailing winds [n -s]
yardangs	"yardang, (turkish) a ridge formed by wind erosion parallel to prevailing winds [n]"
yardarm	either end of a ship's spar [n -s]
yardarms	"yardarm, either end of a ship's spar [n]"
yardbird	an army recruit [n -s]
yardbirds	"yardbird, an army recruit [n]"
yarded	"yard, to enclose in a yard, also yaird [v]"
yarder	"one who yards, drafts animals to a sale yard [n -s]"
yarders	"yarder, one who yards, drafts animals to a sale yard [n]"
yarding	a group of animals displayed for sale [n -s]
yardings	"yarding, a group of animals displayed for sale [n]"
yardland	an english unit of land measure equal to 30 acres [n -s]
yardlands	"yardland, an english unit of land measure equal to 30 acres [n]"
yardman	a male outdoor worker [n yardmen]
yardmaster	a person in charge of a marshalling yard [n -s]
yardmasters	"yardmaster, a person in charge of a marshalling yard [n]"
yardmen	"yardman, a male outdoor worker [n]"
yards	"yard, to enclose in a yard, also yaird [v]"
yardstick	"a stick three feet long; any standard of measurement, also yardwand [n -s]"
yardsticks	"yardstick, a stick three feet long; any standard of measurement, also yardwand [n]"
yardwand	"a stick three feet long; any standard of measurement, also yardstick [n -s]"
yardwands	"yardwand, a stick three feet long; any standard of measurement, also yardstick [n]"
yardwork	the work of caring for a lawn [n -s]
yardworks	"yardwork, the work of caring for a lawn [n]"
yare	"(archaic) nimble, also yar [adj yarer, yarest, yarely]"
yarely	"yare, (archaic) nimble, also yar [adv]"
yarer	"yare, (archaic) nimble, also yar [adj]"
yarest	"yare, (archaic) nimble, also yar [adj]"
yarfa	"in shetland, peaty soil; clayey, sandy or fibrous peat, also yarpha [n -s]"
yarfas	"yarfa, in shetland, peaty soil; clayey, sandy or fibrous peat, also yarpha [n]"
yark	"(dialect) to make ready [v -ed, -ing, -s]"
yarked	"yark, (dialect) to make ready [v]"
yarking	"yark, (dialect) to make ready [v]"
yarks	"yark, (dialect) to make ready [v]"
yarmelke	"(yiddish) a religious skullcap, also yamalka, yamulka, yarmulka, yarmulke [n -s]"
yarmelkes	"yarmelke, (yiddish) a religious skullcap, also yamalka, yamulka, yarmulka, yarmulke [n]"
yarmulka	"(yiddish) a religious skullcap, also yamalka, yamulka, yarmelke, yarmulke [n -s]"
yarmulkas	"yarmulka, (yiddish) a religious skullcap, also yamalka, yamulka, yarmelke, yarmulke [n]"
yarmulke	"(yiddish) a religious skullcap, also yamalka, yamulka, yarmelke, yarmulka [n -s]"
yarmulkes	"yarmulke, (yiddish) a religious skullcap, also yamalka, yamulka, yarmelke, yarmulka [n]"
yarn	"to tell a long story [v -ed, -ing, -s]"
yarned	"yarn, to tell a long story [v]"
yarner	one who tells stories [n -s]
yarners	"yarner, one who tells stories [n]"
yarning	"yarn, to tell a long story [v]"
yarns	"yarn, to tell a long story [v]"
yarpha	"in shetland, peaty soil; clayey, sandy or fibrous peat, also yarfa [n -s]"
yarphas	"yarpha, in shetland, peaty soil; clayey, sandy or fibrous peat, also yarfa [n]"
yarr	"to growl or snarl [v -ed, -ing, -s]"
yarraman	(native australian) a horse [n yarramans or yarramen]
yarramans	"yarraman, (native australian) a horse [n]"
yarramen	"yarraman, (native australian) a horse [n]"
yarran	(native australian) a small eucalyptus tree [n -s]
yarrans	"yarran, (native australian) a small eucalyptus tree [n]"
yarred	"yarr, to growl or snarl [v]"
yarring	"yarr, to growl or snarl [v]"
yarrow	a strongly-scented wild flower [n -s]
yarrows	"yarrow, a strongly-scented wild flower [n]"
yarrs	yarr [n]
yarta	"heart, used as term of endearment in the shetlands, also jarta, yarto [n -s]"
yartas	"yarta, heart, used as term of endearment in the shetlands, also jarta, yarto [n]"
yarto	"heart, used as term of endearment in the shetlands, also jarta, yarta [n -s]"
yartos	"yarto, heart, used as term of endearment in the shetlands, also jarta, yarta [n]"
yas	"ya, an asian pear [n]"
yashmac	"(arabic) a double muslim veil leaving only eyes uncovered, also yashmak, yasmak [n -s]"
yashmacs	"yashmac, (arabic) a double muslim veil leaving only eyes uncovered, also yashmak, yasmak [n]"
yashmak	"(arabic) a double muslim veil leaving only eyes uncovered, also yashmac, yasmak [n -s]"
yashmaks	"yashmak, (arabic) a double muslim veil leaving only eyes uncovered, also yashmac, yasmak [n]"
yasmak	"(arabic) a double muslim veil leaving only eyes uncovered, also yashmac, yashmak [n -s]"
yasmaks	"yasmak, (arabic) a double muslim veil leaving only eyes uncovered, also yashmac, yashmak [n]"
yatagan	"(turkish) a muslim long curved knife, also ataghan, yataghan [n -s]"
yatagans	"yatagan, (turkish) a muslim long curved knife, also ataghan, yataghan [n]"
yataghan	"(turkish) a muslim long curved knife, also ataghan, yatagan [n -s]"
yataghans	"yataghan, (turkish) a muslim long curved knife, also ataghan, yatagan [n]"
yate	"(spenser) a gate, also yett [n -s]"
yates	"yate, (spenser) a gate, also yett [n]"
yatter	"to talk idly [v -ed, -ing, -s]"
yattered	"yatter, to talk idly [v]"
yattering	jabbering [adj yatteringly] / the act of yattering [n -s]
yatteringly	"yattering, jabbering [adv]"
yatterings	"yattering, the act of yattering [n]"
yatters	"yatter, to talk idly [v]"
yaud	"(scots) a mare, a jade [n -s]"
yauds	"yaud, (scots) a mare, a jade [n]"
yauld	"(scots) active, nimble, also yald [adj]"
yaup	"to yelp or bark, also yawp [v -ed, -ing, -s]"
yauped	"yaup, to yelp or bark, also yawp [v]"
yauper	"one who yaups, yelps or barks, also yawper [n -s]"
yaupers	"yauper, one who yaups, yelps or barks, also yawper [n]"
yauping	"yaup, to yelp or bark, also yawp [v]"
yaupon	"(catawba) a bushy evergreen shrub of the holly genus, also yapon, youpon, yupon [n -s]"
yaupons	"yaupon, (catawba) a bushy evergreen shrub of the holly genus, also yapon, youpon, yupon [n]"
yaups	"yaup, to yelp or bark, also yawp [v]"
yautia	(taino) a tropical plant [n -s]
yautias	"yautia, (taino) a tropical plant [n]"
yaw	"of e.g. a plane, to move from right to left in a horizontal plane [v -ed, -ing, -s]"
yawed	"yaw, of e.g. a plane, to move from right to left in a horizontal plane [v]"
yawey	"pertaining to the disease yaws, also yawy [adj yawier, yawiest]"
yawier	"yawy, pertaining to the disease yaws, also yawey [adj]"
yawiest	"yawy, pertaining to the disease yaws, also yawey [adj]"
yawing	"yaw, of e.g. a plane, to move from right to left in a horizontal plane [v]"
yawl	"to howl [v -ed, -ing, -s]"
yawled	"yawl, to howl [v]"
yawling	"yawl, to howl [v]"
yawls	"yawl, to howl [v]"
yawmeter	an instrument in an aircraft [n -s]
yawmeters	"yawmeter, an instrument in an aircraft [n]"
yawn	"to open the mouth in a large gape [v -ed, -ing, -s]"
yawned	"yawn, to open the mouth in a large gape [v]"
yawner	one who yawns [n -s]
yawners	"yawner, one who yawns [n]"
yawnier	"yawny, full of yawns [adj]"
yawniest	"yawny, full of yawns [adj]"
yawning	gaping [adj yawningly] / the act of yawning [n -s]
yawningly	"yawning, gaping [adv]"
yawnings	"yawning, the act of yawning [n]"
yawns	"yawn, to open the mouth in a large gape [v]"
yawnsome	dull and boring; tiresome [adj]
yawny	"full of yawns [adj yawnier, yawniest]"
yawp	"to cry hoarsely or harshly, also yaup [v -ed, -ing, -s]"
yawped	"yawp, to cry hoarsely or harshly, also yaup [v]"
yawper	"one who yawps, cries hoarsely, also yauper [n -s]"
yawpers	"yawper, one who yawps, cries hoarsely, also yauper [n]"
yawping	the act of yelping [n -s]
yawpings	"yawping, the act of yelping [n]"
yawps	"yawp, to cry hoarsely or harshly, also yaup [v]"
yaws	"yaw, of e.g. a plane, to move from right to left in a horizontal plane [v]"
yawy	"pertaining to the disease yaws, also yawey [adj yawier, yawiest]"
yay	"an affirmative vote, also yea [n -s]"
yays	"yay, an affirmative vote, also yea [n]"
ybet	"beat, to strike repeatedly [v]"
yblent	"blend, to mix together [v]"
ybore	"bear, to endure [v]"
ybound	"bind, to tie, fasten [v]"
ybounden	"bind, to tie, fasten [v]"
ybrent	"burn, to destroy by fire [v]"
yclad	"clothe, to provide with clothing [v]"
ycled	"clothe, to provide with clothing [v]"
ycleepe	"to call by name, also clepe [v ycleeped, ycleeping, ycleepes]"
ycleeped	"ycleepe, to call by name, also clepe [v]"
ycleepes	"ycleepe, to call by name, also clepe [v]"
ycleeping	"ycleepe, to call by name, also clepe [v]"
ycleped	"clepe, (archaic) to call, name, also cleep [v]"
yclept	"clepe, (archaic) to call, name, also cleep [v]"
ycond	"con, to study carefully [v]"
ydrad	"dread, to fear greatly [v]"
ydred	"dread, to fear greatly [v]"
ye	(archaic) you [pron]
yea	"an affirmative vote, also yay [n -s]"
yead	"(spenser) to go, proceed, also yede, yeed [v yod or yode, yeading, yeads]"
yeading	"yead, (spenser) to go, proceed, also yede, yeed [v]"
yeads	"yead, (spenser) to go, proceed, also yede, yeed [v]"
yeah	"an expression of yes, also yeh [n -s]"
yeahs	"yeah, an expression of yes, also yeh [n]"
yealdon	"(scott) fuel, also eilding, eldin, elding [n -s]"
yealdons	"yealdon, (scott) fuel, also eilding, eldin, elding [n]"
yealing	"a person of the same age, also yeelin [n -s]"
yealings	"yealing, a person of the same age, also yeelin [n]"
yealm	"to prepare straw for thatching, also yelm [v -ed, -ing, -s]"
yealmed	"yealm, to prepare straw for thatching, also yelm [v]"
yealming	"yealm, to prepare straw for thatching, also yelm [v]"
yealms	"yealm, to prepare straw for thatching, also yelm [v]"
yean	"esp. of a sheep, to bring forth young, also ean [v -ed, -ing, -s]"
yeaned	"yean, esp. of a sheep, to bring forth young, also ean [v]"
yeaning	"yean, esp. of a sheep, to bring forth young, also ean [v]"
yeanling	"an animal that is undergoing the process of weaning, also eanling, weanel, weanling [n -s]"
yeanlings	"yeanling, an animal that is undergoing the process of weaning, also eanling, weanel, weanling [n]"
yeans	"yean, esp. of a sheep, to bring forth young, also ean [v]"
year	the time taken by the earth to orbit the sun [n -s]
yearbook	a book published annually [n -s]
yearbooks	"yearbook, a book published annually [n]"
yeard	"(scots) to bury, also eard, yerd, yird, yirth [v -ed, -ing, -s]"
yearded	"yeard, (scots) to bury, also eard, yerd, yird, yirth [v]"
yearding	"yeard, (scots) to bury, also eard, yerd, yird, yirth [v]"
yeards	"yeard, (scots) to bury, also eard, yerd, yird, yirth [v]"
yearend	the end of the year [n -s]
yearends	"yearend, the end of the year [n]"
yearlies	"yearly, a once a year publication [n]"
yearling	a horse of either sex during 1 january to 31 december following the year of its birth [n -s]
yearlings	"yearling, a horse of either sex during 1 january to 31 december following the year of its birth [n]"
yearlong	lasting a year [adj]
yearly	a once a year publication [n yearlies]
yearn	"to long for [v -ed, -ing, -s]"
yearned	"yearn, to long for [v]"
yearner	one who yearns [n -s]
yearners	"yearner, one who yearns [n]"
yearning	a strong or deep desire [n -s]
yearningly	yearning [adv]
yearnings	"yearning, a strong or deep desire [n]"
yearns	"yearn, to long for [v]"
years	"year, the time taken by the earth to orbit the sun [n]"
yeas	"yea, an affirmative vote, also yay [n]"
yeasayer	a person who (habitually) agrees or assents [n -s]
yeasayers	"yeasayer, a person who (habitually) agrees or assents [n]"
yeast	"to ferment [v -ed, -ing, -s]"
yeasted	"yeast, to ferment [v]"
yeastier	"yeasty, like yeast, also yesty [adj]"
yeastiest	"yeasty, like yeast, also yesty [adj]"
yeastily	"yeasty, like yeast, also yesty [adv]"
yeastiness	the state of being yeasty [n -es]
yeastinesses	"yeastiness, the state of being yeasty [n]"
yeasting	"yeast, to ferment [v]"
yeastless	without yeast [adj]
yeastlike	"like yeast, frothy [adj]"
yeasts	"yeast, to ferment [v]"
yeasty	"like yeast, also yesty [adj yeastier, yeastiest, yeastily]"
yebo	"(south african) yes, i agree [interj]"
yecch	something disgusting [n -s]
yecchs	"yecch, something disgusting [n]"
yech	"something disgusting, also yecch [n -s]"
yechier	"yechy, disgusting [adj]"
yechiest	"yechy, disgusting [adj]"
yechs	"yech, something disgusting, also yecch [n]"
yechy	"disgusting [adj yechier, yechiest]"
yede	"to go or proceed, also yeed [v yod or yode, yeding, yedes]"
yedes	"yede, to go or proceed, also yeed [v]"
yeding	"yede, to go or proceed, also yeed [v]"
yeed	"to go or proceed, also yead, yede [v yod or yode, yeeding, yeeds]"
yeeding	"yeed, to go or proceed, also yead, yede [v]"
yeeds	"yeed, to go or proceed, also yead, yede [v]"
yeelin	"a person of the same age, also yealing [n -s]"
yeelins	"yeelin, a person of the same age, also yealing [n]"
yeesh	an interjection used to express frustration [interj]
yegg	"a burglar esp. of safes, also yeggman [n -s]"
yeggman	"a burglar esp. of safes, also yegg [n yeggmen]"
yeggmen	"yeggman, a burglar esp. of safes, also yegg [n]"
yeggs	"yegg, a burglar esp. of safes, also yeggman [n]"
yeh	"(colloquial) yes, also yeah [interj]"
yeld	"barren, not giving milk [adj]"
yeldring	"the yellowhammer, also yeldrock, yoldring, yorling, yowley [n -s]"
yeldrings	"yeldring, the yellowhammer, also yeldrock, yoldring, yorling, yowley [n]"
yeldrock	"the yellowhammer, also yeldring, yoldring, yorling, yowley [n -s]"
yeldrocks	"yeldrock, the yellowhammer, also yeldring, yoldring, yorling, yowley [n]"
yelk	"the yellow, fatty part of an egg, also yolk [n -s]"
yelks	"yelk, the yellow, fatty part of an egg, also yolk [n]"
yell	"to cry out loudly [v -ed, -ing, -s]"
yelled	"yell, to cry out loudly [v]"
yeller	one who cries out [n -s]
yellers	"yeller, one who cries out [n]"
yelling	the act of crying out [n -s]
yellings	"yelling, the act of crying out [n]"
yelloch	"(scots) to yell [v -ed, -ing, -s]"
yelloched	"yelloch, (scots) to yell [v]"
yelloching	"yelloch, (scots) to yell [v]"
yellochs	"yelloch, (scots) to yell [v]"
yellow	"of a bright color like that of ripe lemons [adj yellower, yellowest, yellowly] / to make or become yellow [v -ed, -ing, -s]"
yellowback	a cheap sensational novel [n -s]
yellowbacks	"yellowback, a cheap sensational novel [n]"
yellowbark	the calisaya tree [n -s]
yellowbarks	"yellowbark, the calisaya tree [n]"
yellowbird	"the american goldfinch, or thistle bird [n -s]"
yellowbirds	"yellowbird, the american goldfinch, or thistle bird [n]"
yellowcake	uranium oxide [n -s]
yellowcakes	"yellowcake, uranium oxide [n]"
yellowed	"yellow, to make or become yellow [v]"
yellower	"yellow, of a bright color like that of ripe lemons [adj]"
yellowest	"yellow, of a bright color like that of ripe lemons [adj]"
yellowfin	a kind of tuna with yellowish fins [n -s]
yellowfins	"yellowfin, a kind of tuna with yellowish fins [n]"
yellowhammer	a small yellow bird of the finch family [n -s]
yellowhammers	"yellowhammer, a small yellow bird of the finch family [n]"
yellowhead	a species of flycatcher found in new zealand [n -s]
yellowheads	"yellowhead, a species of flycatcher found in new zealand [n]"
yellowier	"yellowy, yellowish [adj]"
yellowiest	"yellowy, yellowish [adj]"
yellowing	"yellow, to make or become yellow [v]"
yellowish	somewhat yellow [adj]
yellowishness	the state of being yellowish [n -es]
yellowishnesses	"yellowishness, the state of being yellowish [n]"
yellowlegs	"any one of several species of long-legged sandpipers, in which the legs are bright yellow [n]"
yellowly	"yellow, of a bright color like that of ripe lemons [adv]"
yellowness	the state of being yellow [n -es]
yellownesses	"yellowness, the state of being yellow [n]"
yellows	"yellow, to make or become yellow [v]"
yellowtail	"any one of several species of marine carangoid fishes, esteemed as food fish [n -s]"
yellowtails	"yellowtail, any one of several species of marine carangoid fishes, esteemed as food fish [n]"
yellowthroat	any of several largely olive american warblers [n -s]
yellowthroats	"yellowthroat, any of several largely olive american warblers [n]"
yellowware	pottery made from buff clay and covered with a transparent yellow clay [n -s]
yellowwares	"yellowware, pottery made from buff clay and covered with a transparent yellow clay [n]"
yellowweed	"any of various yellow-flowered plants, such as the ragwort in europe and some species of goldenrod in the united states [n -s]"
yellowweeds	"yellowweed, any of various yellow-flowered plants, such as the ragwort in europe and some species of goldenrod in the united states [n]"
yellowwood	the wood of any one of several different kinds of trees [n -s]
yellowwoods	"yellowwood, the wood of any one of several different kinds of trees [n]"
yellowwort	a yellow-flowered plant of the gentian family [n -s]
yellowworts	"yellowwort, a yellow-flowered plant of the gentian family [n]"
yellowy	"yellowish [adj yellowier, yellowiest]"
yells	"yell, to cry out loudly [v]"
yelm	"to prepare straw for thatching, also yealm [v -ed, -ing, -s]"
yelmed	"yelm, to prepare straw for thatching, also yealm [v]"
yelming	"yelm, to prepare straw for thatching, also yealm [v]"
yelms	"yelm, to prepare straw for thatching, also yealm [v]"
yelp	"to utter a sharp cry [v -ed, -ing, -s]"
yelped	"yelp, to utter a sharp cry [v]"
yelper	one who yelps [n -s]
yelpers	"yelper, one who yelps [n]"
yelping	the act of yelping [n -s]
yelpings	"yelping, the act of yelping [n]"
yelps	"yelp, to utter a sharp cry [v]"
yelt	"(dialect) a young sow, also elt, gilt [n -s]"
yelts	"yelt, (dialect) a young sow, also elt, gilt [n]"
yemmer	(dialect) an ember [n -s]
yemmers	"yemmer, (dialect) an ember [n]"
yen	"to desire or yearn [v yenned, yenning, yens]"
yenned	"yen, to desire or yearn [v]"
yenning	"yen, to desire or yearn [v]"
yens	"yen, to desire or yearn [v]"
yenta	"(yiddish) a gossipy woman, esp. one who pries, also yente [n -s]"
yentas	"yenta, (yiddish) a gossipy woman, esp. one who pries, also yente [n]"
yente	"(yiddish) a gossipy woman, esp. one who pries, also yenta [n -s]"
yentes	"yente, (yiddish) a gossipy woman, esp. one who pries, also yenta [n]"
yeoman	"a member of a class of small farmers, usually freeholders, the next grade below gentlemen [n yeomen]"
yeomanly	of yeoman rank [adj]
yeomanries	"yeomanry, a collective body of yeomen [n]"
yeomanry	a collective body of yeomen [n yeomanries]
yeomen	"yeoman, a member of a class of small farmers, usually freeholders, the next grade below gentlemen [n]"
yeow	an interjection used to express pain or shock [interj]
yep	"(colloquial) yes, also yup [n -s]"
yeps	"yep, (colloquial) yes, also yup [n]"
yer	(colloquial) your; you [adj]
yerba	(spanish) an infusion of the leaves of a south american shrub [n -s]
yerbas	"yerba, (spanish) an infusion of the leaves of a south american shrub [n]"
yerd	"(scots) to bury, also eard, yeard, yird, yirth [v -ed, -ing, -s]"
yerded	"yerd, (scots) to bury, also eard, yeard, yird, yirth [v]"
yerding	"yerd, (scots) to bury, also eard, yeard, yird, yirth [v]"
yerds	"yerd, (scots) to bury, also eard, yeard, yird, yirth [v]"
yerk	"to tie with a jerk, also yirk [v -ed, -ing, -s]"
yerked	"yerk, to tie with a jerk, also yirk [v]"
yerking	"yerk, to tie with a jerk, also yirk [v]"
yerks	"yerk, to tie with a jerk, also yirk [v]"
yersinia	"a bacterium spread by birds and animals, causing plague [n yersinias or yersiniae]"
yersiniae	"yersinia, a bacterium spread by birds and animals, causing plague [n]"
yersinias	"yersinia, a bacterium spread by birds and animals, causing plague [n]"
yersinioses	"yersiniosis, an acute infection of the small intestine [n]"
yersiniosis	an acute infection of the small intestine [n yersinioses]
yes	"an affirmative reply [n yeses or yesses] / to give an affirmative reply to [v yessed, yessing, yesses]"
yeses	"yes, to give an affirmative reply to [v]"
yeshiva	"(hebrew) a school for the study of the jewish scripture, the talmud, also yeshivah [n yeshivas, yeshivot, yeshivoth]"
yeshivah	"(hebrew) a school for the study of the jewish scripture, the talmud, also yeshiva [n -s]"
yeshivahs	"yeshivah, (hebrew) a school for the study of the jewish scripture, the talmud, also yeshiva [n]"
yeshivas	"yeshiva, (hebrew) a school for the study of the jewish scripture, the talmud, also yeshivah [n]"
yeshivot	"yeshiva, (hebrew) a school for the study of the jewish scripture, the talmud, also yeshivah [n]"
yeshivoth	"yeshiva, (hebrew) a school for the study of the jewish scripture, the talmud, also yeshivah [n]"
yesk	"(scots) to hiccup or belch, also yex [v -ed, -ing, -s]"
yesked	"yesk, (scots) to hiccup or belch, also yex [v]"
yesking	"yesk, (scots) to hiccup or belch, also yex [v]"
yesks	"yesk, (scots) to hiccup or belch, also yex [v]"
yessed	"yes, to give an affirmative reply to [v]"
yesses	"yes, to give an affirmative reply to [v]"
yessing	"yes, to give an affirmative reply to [v]"
yessir	"an interjection used to express assent, also yessiree [interj]"
yessiree	"an interjection used to express assent, also yessir [interj]"
yessum	an interjection used to express assent to a woman [interj]
yest	(obsolete) yeast [n -s]
yester	"pertaining to yesterday, also yestern [adj]"
yesterday	on the day immediately before today [adv] / the day immediately before today [n -s]
yesterdays	"yesterday, the day immediately before today [n]"
yestereve	"yesterday evening, also yestereven, yesterevening, yestreen [n -s]"
yestereven	"yesterday evening, also yestereve, yesterevening, yestreen [n -s]"
yesterevening	"yesterday evening, also yestereve, yestereven, yestreen [n -s]"
yesterevenings	"yesterevening, yesterday evening, also yestereve, yestereven, yestreen [n]"
yesterevens	"yestereven, yesterday evening, also yestereve, yesterevening, yestreen [n]"
yestereves	"yestereve, yesterday evening, also yestereven, yesterevening, yestreen [n]"
yestermorn	yesterday morning [n -s]
yestermorning	yesterday evening or morning [n -s]
yestermornings	"yestermorning, yesterday evening or morning [n]"
yestermorns	"yestermorn, yesterday morning [n]"
yestern	"pertaining to yesterday, also yester [adj]"
yesternight	(dialect) last night [n -s]
yesternights	"yesternight, (dialect) last night [n]"
yesteryear	"last year, or the past in general [n -s]"
yesteryears	"yesteryear, last year, or the past in general [n]"
yestreen	"the evening of yesterday, also yestereve, yestereven, yesterevening [n -s]"
yestreens	"yestreen, the evening of yesterday, also yestereve, yestereven, yesterevening [n]"
yests	"yest, (obsolete) yeast [n]"
yesty	"like yeast, also yeasty [adj]"
yet	"in addition, besides; nevertheless [adv]"
yeti	(tibetan) the abominable snowman [n -s]
yetis	"yeti, (tibetan) the abominable snowman [n]"
yett	"(scots) a gate, door, also yate [n -s]"
yettie	"(colloquial) a young, entrepreneurial and technology-based person [n -s]"
yetties	"yettie, (colloquial) a young, entrepreneurial and technology-based person [n]"
yetts	"yett, (scots) a gate, door, also yate [n]"
yeuk	"(dialect) to itch, also euk, ewk, youk, yuke [v -ed, -ing, -s]"
yeuked	"yeuk, (dialect) to itch, also euk, ewk, youk, yuke [v]"
yeukier	"yeuky, itchy [adj]"
yeukiest	"yeuky, itchy [adj]"
yeuking	"yeuk, (dialect) to itch, also euk, ewk, youk, yuke [v]"
yeuks	"yeuk, (dialect) to itch, also euk, ewk, youk, yuke [v]"
yeuky	"itchy [adj yeukier, yeukiest]"
yeve	"(obsolete) to give [v yeven, yeving, yeves]"
yeven	"yeve, (obsolete) to give [v]"
yeves	"yeve, (obsolete) to give [v]"
yeving	"yeve, (obsolete) to give [v]"
yew	"a type of evergreen tree, also eugh [n -s]"
yewen	"(archaic) made of yew wood, also eughen, ewghen [adj]"
yews	"yew, a type of evergreen tree, also eugh [n]"
yex	"to hiccup, also yesk [v -ed, -ing, -es]"
yexed	"yex, to hiccup, also yesk [v]"
yexes	"yex, to hiccup, also yesk [v]"
yexing	"yex, to hiccup, also yesk [v]"
yez	(colloquial) yes [interj]
yfere	"(obsolete) a friend, comrade, companion, or associate [n -s]"
yferes	"yfere, (obsolete) a friend, comrade, companion, or associate [n]"
yglaunst	"glance, to look quickly [v]"
ygo	"go, to move along [v]"
ygoe	"go, to move along [v]"
yibbles	"(scots) perhaps, also ablings, ablins, aiblins [adv]"
yicker	"to utter sharp little cries of an animal, also yikker [v -ed, -ing, -s]"
yickered	"yicker, to utter sharp little cries of an animal, also yikker [v]"
yickering	"yicker, to utter sharp little cries of an animal, also yikker [v]"
yickers	"yicker, to utter sharp little cries of an animal, also yikker [v]"
yid	an offensive term for a jew [n -s]
yidaki	(native australian) a long wooden wind instrument played by the aboriginal people of arnhem land [n -s]
yidakis	"yidaki, (native australian) a long wooden wind instrument played by the aboriginal people of arnhem land [n]"
yids	"yid, an offensive term for a jew [n]"
yield	"to give up [v yielded or (obsolete) yold, yielding, yields]"
yieldable	disposed to yield or comply [adj]
yieldableness	the quality of being yieldable [n -es]
yieldablenesses	"yieldableness, the quality of being yieldable [n]"
yielded	"yield, to give up [v]"
yielder	one who yields [n -s]
yielders	"yielder, one who yields [n]"
yielding	"giving way, compliant [adj yieldingly] / a giving way [n -s]"
yieldingly	"yielding, giving way, compliant [adv]"
yieldingness	the quality of being yielding [n -es]
yieldingnesses	"yieldingness, the quality of being yielding [n]"
yieldings	"yielding, a giving way [n]"
yields	"yield, to give up [v]"
yike	"(australian slang) to squabble, argue [v yiked, yiking, yikes]"
yiked	"yike, (australian slang) to squabble, argue [v]"
yikes	"yike, (australian slang) to squabble, argue [v]"
yiking	"yike, (australian slang) to squabble, argue [v]"
yikker	"to utter sharp little cries of an animal, also yicker [v -ed, -ing, -s]"
yikkered	"yikker, to utter sharp little cries of an animal, also yicker [v]"
yikkering	"yikker, to utter sharp little cries of an animal, also yicker [v]"
yikkers	"yikker, to utter sharp little cries of an animal, also yicker [v]"
yill	"(scots) to entertain or delight with ale [v -ed, -ing, -s]"
yilled	"yill, (scots) to entertain or delight with ale [v]"
yilling	"yill, (scots) to entertain or delight with ale [v]"
yills	yill [n]
yin	"(scots) one, also ane [n -s]"
yince	"(scots) once, also ance [adv]"
yindie	a person in his or her early 30's who combines a lucrative career with non-mainstream tastes [n -s]
yindies	"yindie, a person in his or her early 30's who combines a lucrative career with non-mainstream tastes [n]"
yingyang	"(in chinese philosophy and religion) two principles, one negative, dark, and feminine (yin) and one positive, bright, and masculine (yang) whose interaction influences the destinies of creatures and things [n -s]"
yingyangs	"yingyang, (in chinese philosophy and religion) two principles, one negative, dark, and feminine (yin) and one positive, bright, and masculine (yang) whose interaction influences the destinies of creatures and things [n]"
yins	"yin, (scots) one, also ane [n]"
yip	"to utter a short, sudden cry [v yipped, yipping, yips]"
yipe	"an interjection expressing fear or surprise, also yipes [interj]"
yipes	"used to express fear or surprise, also yipe [interj]"
yipped	"yip, to utter a short, sudden cry [v]"
yippee	an exclamation of delight [interj]
yipper	a golfer suffering from yips [n -s]
yippers	"yipper, a golfer suffering from yips [n]"
yippie	"a member of a radical political group founded in 1967 with ideals based on those of the hippies, also yippy [n -s]"
yippies	"yippy, a member of a radical political group founded in 1967 with ideals based on those of the hippies, also yippie [n]"
yipping	"yip, to utter a short, sudden cry [v]"
yippy	"a member of a radical political group founded in 1967 with ideals based on those of the hippies, also yippie [n yippies]"
yips	"yip, to utter a short, sudden cry [v]"
yird	"(scots) to bury, also eard, yeard, yerd, yirth [v -ed, -ing, -s]"
yirded	"yird, (scots) to bury, also eard, yeard, yerd, yirth [v]"
yirding	"yird, (scots) to bury, also eard, yeard, yerd, yirth [v]"
yirds	"yird, (scots) to bury, also eard, yeard, yerd, yirth [v]"
yirk	"to draw tight [v -ed, -ing, -s]"
yirked	"yirk, to draw tight [v]"
yirking	"yirk, to draw tight [v]"
yirks	"yirk, to draw tight [v]"
yirr	"to snarl [v -ed, -ing, -s]"
yirred	"yirr, to snarl [v]"
yirring	"yirr, to snarl [v]"
yirrs	"yirr, to snarl [v]"
yirth	(us) earth [n -s]
yirths	"yirth, (us) earth [n]"
yite	"(dialect) the yellowhammer, also yitie [n -s]"
yites	"yite, (dialect) the yellowhammer, also yitie [n]"
yitie	"(scots) the yellowhammer, also yite [n -s]"
yities	"yitie, (scots) the yellowhammer, also yite [n]"
yitten	(dialect) frightened [adj]
ylem	a form of matter hypothesized by proponents of the big bang theory to have existed before the formation of the chemical elements [n -s]
ylems	"ylem, a form of matter hypothesized by proponents of the big bang theory to have existed before the formation of the chemical elements [n]"
ylike	(spenser) alike [adj]
ylke	(obsolete) ilk [n -s]
ylkes	"ylke, (obsolete) ilk [n]"
ymolt	"melt, to change from a solid to a liquid state by heat [v]"
ymolten	"melt, to change from a solid to a liquid state by heat [v]"
ympe	"(spenser) to imp [v ympt, ymping, ympes]"
ympes	"ympe, (spenser) to imp [v]"
ymping	"ympe, (spenser) to imp [v]"
ympt	"ympe, (spenser) to imp [v]"
ynambu	"(tupi) a south american bird, a large tinamou [n -s]"
ynambus	"ynambu, (tupi) a south american bird, a large tinamou [n]"
yo	an expression of calling for attention [interj]
yob	"a lout, also yobbo [n -s]"
yobberies	"yobbery, loutish behaviour, also yobbism [n]"
yobbery	"loutish behaviour, also yobbism [n yobberies]"
yobbier	"yobby, resembling a yob [adj]"
yobbiest	"yobby, resembling a yob [adj]"
yobbish	like a yob [adj yobbishly]
yobbishly	"yobbish, like a yob [adv]"
yobbism	"loutish behaviour, also yobbery [n -s]"
yobbisms	"yobbism, loutish behaviour, also yobbery [n]"
yobbo	"(slang) a yob, a hoodlum [n yobbos or yobboes]"
yobboes	"yobbo, (slang) a yob, a hoodlum [n]"
yobbos	"yobbo, (slang) a yob, a hoodlum [n]"
yobby	"resembling a yob [adj yobbier, yobbiest]"
yobs	"yob, a lout, also yobbo [n]"
yock	"to laugh boisterously also yok [v -ed, -ing, -s]"
yocked	"yock, to laugh boisterously also yok [v]"
yocking	"yock, to laugh boisterously also yok [v]"
yocks	"yock, to laugh boisterously also yok [v]"
yoctosecond	a very small unit of time [n -s]
yoctoseconds	"yoctosecond, a very small unit of time [n]"
yod	"a hebrew letter, also yodh [n -s]"
yode	"yead, (spenser) to go, proceed, also yede, yeed [v]"
yodel	"to sing with a fluctuating voice, also jodel, yodle [v yodelled or yodeled, yodelling or yodeling, yodels]"
yodeled	"yodel, to sing with a fluctuating voice, also jodel, yodle [v]"
yodeler	"one who yodels, also yodeller [n -s]"
yodelers	"yodeler, one who yodels, also yodeller [n]"
yodeling	"yodel, to sing with a fluctuating voice, also jodel, yodle [v]"
yodelled	"yodel, to sing with a fluctuating voice, also jodel, yodle [v]"
yodeller	"one who yodels, also yodeler [n -s]"
yodellers	"yodeller, one who yodels, also yodeler [n]"
yodelling	"yodel, to sing with a fluctuating voice, also jodel, yodle [v]"
yodels	"yodel, to sing with a fluctuating voice, also jodel, yodle [v]"
yodh	"(hebrew) a hebrew letter, also yod [n -s]"
yodhs	"yodh, (hebrew) a hebrew letter, also yod [n]"
yodle	"to sing with a fluctuating voice, also jodel, yodel [v yodled, yodling, yodles]"
yodled	"yodle, to sing with a fluctuating voice, also jodel, yodel [v]"
yodler	"one who yodels, also yodeler, yodeller [n -s]"
yodlers	"yodler, one who yodels, also yodeler, yodeller [n]"
yodles	"yodle, to sing with a fluctuating voice, also jodel, yodel [v]"
yodling	"yodle, to sing with a fluctuating voice, also jodel, yodel [v]"
yods	"yod, a hebrew letter, also yodh [n]"
yoga	(sanskrit) a system of hindu philosophy [n -s]
yogas	"yoga, (sanskrit) a system of hindu philosophy [n]"
yogee	"one who practises yoga, also yogi, yogin [n -s]"
yogees	"yogee, one who practises yoga, also yogi, yogin [n]"
yogh	the middle english letter representing a velar or partial fricative [n -s]
yoghourt	"(turkish) a semisolid, somewhat sour foodstuff, made from milk curdled by the addition of certain bacteria, also yaourt, yoghurt, yogourt, yogurt [n -s]"
yoghourts	"yoghourt, (turkish) a semisolid, somewhat sour foodstuff, made from milk curdled by the addition of certain bacteria, also yaourt, yoghurt, yogourt, yogurt [n]"
yoghs	"yogh, the middle english letter representing a velar or partial fricative [n]"
yoghurt	"(turkish) a semisolid, somewhat sour foodstuff, made from milk curdled by the addition of certain bacteria, also yaourt, yoghourt, yogourt, yogurt [n -s]"
yoghurts	"yoghurt, (turkish) a semisolid, somewhat sour foodstuff, made from milk curdled by the addition of certain bacteria, also yaourt, yoghourt, yogourt, yogurt [n]"
yogi	"(sanskrit) one who practises yoga, also yogee, yogin [n -s]"
yogic	relating to yoga [adj]
yogin	"one who practices yoga, also yogee, yogi [n -s]"
yogini	a female yogi [n -s]
yoginis	"yogini, a female yogi [n]"
yogins	"yogin, one who practices yoga, also yogee, yogi [n]"
yogis	"yogi, (sanskrit) one who practises yoga, also yogee, yogin [n]"
yogism	the art of yogi [n -s]
yogisms	"yogism, the art of yogi [n]"
yogourt	"(turkish) a semisolid, somewhat sour foodstuff, made from milk curdled by the addition of certain bacteria, also yaourt, yoghourt, yoghurt, yogurt [n -s]"
yogourts	"yogourt, (turkish) a semisolid, somewhat sour foodstuff, made from milk curdled by the addition of certain bacteria, also yaourt, yoghourt, yoghurt, yogurt [n]"
yogurt	"(turkish) a semisolid, somewhat sour foodstuff, made from milk curdled by the addition of certain bacteria, also yaourt, yoghourt, yoghurt, yogourt [n -s]"
yogurts	"yogurt, (turkish) a semisolid, somewhat sour foodstuff, made from milk curdled by the addition of certain bacteria, also yaourt, yoghourt, yoghurt, yogourt [n]"
yohimbe	(bantu) a tropical african tree [n -s]
yohimbes	"yohimbe, (bantu) a tropical african tree [n]"
yohimbine	(bantu) an alkaloid obtained from the bark of a west african tree [n -s]
yohimbines	"yohimbine, (bantu) an alkaloid obtained from the bark of a west african tree [n]"
yoick	"to cry out an old fox-hunting cry, also yoicks [v -ed, -ing, -s]"
yoicked	"yoick, to cry out an old fox-hunting cry, also yoicks [v]"
yoicking	"yoick, to cry out an old fox-hunting cry, also yoicks [v]"
yoicks	"to cry out an old fox-hunting cry, also yoick [v -ed, -ing, -es]"
yoicksed	"yoicks, to cry out an old fox-hunting cry, also yoick [v]"
yoickses	"yoicks, to cry out an old fox-hunting cry, also yoick [v]"
yoicksing	"yoicks, to cry out an old fox-hunting cry, also yoick [v]"
yojan	"(hindi) in the indian subcontinent, a measure of distance, also yojana [n -s]"
yojana	"(hindi) in the indian subcontinent, a measure of distance, also yojan [n -s]"
yojanas	"yojana, (hindi) in the indian subcontinent, a measure of distance, also yojan [n]"
yojans	"yojan, (hindi) in the indian subcontinent, a measure of distance, also yojana [n]"
yok	"to laugh loudly, also yock, yuck, yuk [v yokked, yokking, yoks]"
yoke	"to join (animals, slaves) together wth a wooden frame [v yoked, yoking, yokes]"
yoked	"yoke, to join (animals, slaves) together wth a wooden frame [v]"
yokefellow	a mate; a fellow; esp. a partner in marriage [n -s]
yokefellows	"yokefellow, a mate; a fellow; esp. a partner in marriage [n]"
yokel	a country bumpkin [n -s]
yokeless	without a yoke [adj]
yokelish	like a country bumpkin [adj]
yokels	"yokel, a country bumpkin [n]"
yokemate	a working companion [n -s]
yokemates	"yokemate, a working companion [n]"
yoker	"to spit [v -ed, -ing, -s]"
yokered	"yoker, to spit [v]"
yokering	"yoker, to spit [v]"
yokers	"yoker, to spit [v]"
yokes	"yoke, to join (animals, slaves) together wth a wooden frame [v]"
yoking	(dialect) as much work as is done at one time [n -s]
yokings	"yoking, (dialect) as much work as is done at one time [n]"
yokked	"yok, to laugh loudly, also yock, yuck, yuk [v]"
yokking	"yok, to laugh loudly, also yock, yuck, yuk [v]"
yokozuna	(japanese) a champion sumo wrestler [n -s]
yokozunas	"yokozuna, (japanese) a champion sumo wrestler [n]"
yoks	"yok, to laugh loudly, also yock, yuck, yuk [v]"
yokul	"(shetlands) yes carl, also jokol [interj]"
yold	"yield, to give up [v]"
yoldring	"the yellowhammer, also yeldring, yeldrock, yorling, yowley [n -s]"
yoldrings	"yoldring, the yellowhammer, also yeldring, yeldrock, yorling, yowley [n]"
yolk	"the yellow, fatty part of an egg, also yelk [n -s]"
yolked	having a yolk [adj]
yolkier	"yolky, like yolk [adj]"
yolkiest	"yolky, like yolk [adj]"
yolkless	having no yolk [adj]
yolks	"yolk, the yellow, fatty part of an egg, also yelk [n]"
yolky	"like yolk [adj yolkier, yolkiest]"
yom	"a jewish day, esp. in a religious context [n yomim]"
yomim	"yom, a jewish day, esp. in a religious context [n]"
yomp	"to march with heavy equipment over difficult terrain; to cover a certain distance in this way [v -ed, -ing, -s]"
yomped	"yomp, to march with heavy equipment over difficult terrain; to cover a certain distance in this way [v]"
yomping	"yomp, to march with heavy equipment over difficult terrain; to cover a certain distance in this way [v]"
yomps	"yomp, to march with heavy equipment over difficult terrain; to cover a certain distance in this way [v]"
yon	"over there, also thon, thonder, yond, yonder, yont [adj]"
yond	"ovetr there, also thon, thonder, yon, yonder, yont [adv]"
yonder	"over there, also thon, thonder, yon, yond, yont [adj] / the distance [n -s]"
yonderly	(dialect) mentally or emotionally distant; absentminded [adj]
yonders	"yonder, the distance [n]"
yoni	(sanskrit) a representation of the female genitals [n -s]
yonic	pertaining to the yoni [adj]
yonis	"yoni, (sanskrit) a representation of the female genitals [n]"
yonker	"(obsolete) a young person, also younker [n -s]"
yonkers	"yonker, (obsolete) a young person, also younker [n]"
yonks	"(colloquial) ages, a long time [n]"
yonnie	(australian slang) a child's word for a stone [n -s]
yonnies	"yonnie, (australian slang) a child's word for a stone [n]"
yont	"over there, also thon, thonder, yon, yond, yonder [adj]"
yoof	"youth, young people [n -s]"
yoofs	"yoof, youth, young people [n]"
yoop	a sobbing sound [n -s]
yoops	"yoop, a sobbing sound [n]"
yopper	a young person employed through a youth employment programme [n -s]
yoppers	"yopper, a young person employed through a youth employment programme [n]"
yore	a long time ago [n -s]
yores	"yore, a long time ago [n]"
york	"to bowl a batsman with a yorker [v -ed, -ing, -s]"
yorked	"york, to bowl a batsman with a yorker [v]"
yorker	a kind of delivery in cricket [n -s]
yorkers	"yorker, a kind of delivery in cricket [n]"
yorkie	a yorkshire terrier [n -s]
yorkies	"yorkie, a yorkshire terrier [n]"
yorking	"york, to bowl a batsman with a yorker [v]"
yorks	"york, to bowl a batsman with a yorker [v]"
yorling	"as in yellow yorling, a yellowhammer, also yeldring, yeldrock, yoldring, yowley [n -s]"
yorlings	"yorling, as in yellow yorling, a yellowhammer, also yeldring, yeldrock, yoldring, yowley [n]"
yorp	"(dialect) to shout [v -ed, -ing, -s]"
yorped	"yorp, (dialect) to shout [v]"
yorping	"yorp, (dialect) to shout [v]"
yorps	"yorp, (dialect) to shout [v]"
yottabyte	a very large unit of computer memory [n -s]
yottabytes	"yottabyte, a very large unit of computer memory [n]"
you	"a pronoun referring to the person being addressed [pron yous, youse]"
youk	"(dialect) to itch, also euk, ewk, yeuk, yuke [v -ed, -ing, -s]"
youked	"youk, (dialect) to itch, also euk, ewk, yeuk, yuke [v]"
youking	"youk, (dialect) to itch, also euk, ewk, yeuk, yuke [v]"
youks	"youk, (dialect) to itch, also euk, ewk, yeuk, yuke [v]"
young	"born recently [adj younger, youngest, youngly] / the young of a species [n -s]"
youngberries	"youngberry, a large reddish-black fruit, a cross between a blackberry and a dewberry [n]"
youngberry	"a large reddish-black fruit, a cross between a blackberry and a dewberry [n youngberries]"
younger	an inferior in age [n -s]
youngers	"younger, an inferior in age [n]"
youngest	"young, born recently [adj]"
youngish	somewhat young [adj]
youngling	(archaic) a young person or animal [n -s]
younglings	"youngling, (archaic) a young person or animal [n]"
youngly	in the manner of youth [adv]
youngness	the state of being young [n -es]
youngnesses	"youngness, the state of being young [n]"
youngs	"young, the young of a species [n]"
youngster	a young person [n -s]
youngsters	"youngster, a young person [n]"
youngth	"(spenser) youth, also youthhead, youthhood [n -s]"
youngthly	"(spenser) youthful, also youthly, youthsome, youthy [adj]"
youngths	"youngth, (spenser) youth, also youthhead, youthhood [n]"
younker	"(colloquial) a young person, also yonker [n -s]"
younkers	"younker, (colloquial) a young person, also yonker [n]"
youpon	"(catawba) a bushy evergreen shrub of the holly genus, also yapon, yaupon, yupon [n -s]"
youpons	"youpon, (catawba) a bushy evergreen shrub of the holly genus, also yapon, yaupon, yupon [n]"
your	belonging to you [adj]
yourn	(archaic) yours [pron]
yours	"a possessive form of the pronoun you, also yourn [pron]"
yourself	a form of the second person pronoun [pron yourselves]
yourselves	yourself [n]
yourt	"(russian) a mongolian tent made of felt, also yurt, yurta [n -s]"
yourts	"yourt, (russian) a mongolian tent made of felt, also yurt, yurta [n]"
yous	"(colloquial) you when addressing more than one person, also youse [pron]"
youse	"(colloquial) you when addressing more than one person, also yous [pron]"
youth	a young person [n -s]
youthen	"to make or grow young [v -ed, -ing, -s]"
youthened	"youthen, to make or grow young [v]"
youthening	"youthen, to make or grow young [v]"
youthens	"youthen, to make or grow young [v]"
youthful	young [adj youthfully]
youthfully	"youthful, young [adv]"
youthfulness	the state of being youthful [n -es]
youthfulnesses	"youthfulness, the state of being youthful [n]"
youthhead	"(obsolete) youth, also youngth, youthhood [n -s]"
youthheads	"youthhead, (obsolete) youth, also youngth, youthhood [n]"
youthhood	"(obsolete) youth, also youngth, youthhead [n -s]"
youthhoods	"youthhood, (obsolete) youth, also youngth, youthhead [n]"
youthier	"youthy, (scots) young, also youngthly, youthly, youthsome [adj]"
youthiest	"youthy, (scots) young, also youngthly, youthly, youthsome [adj]"
youthless	without youth [adj]
youthly	"(spenser) youthful, also youngthly, youthsome, youthy [adj]"
youthquake	"a shift in cultural norms influenced by the values, tastes, and mores of young people [n -s]"
youthquakes	"youthquake, a shift in cultural norms influenced by the values, tastes, and mores of young people [n]"
youths	"youth, a young person [n]"
youthsome	"(obsolete) youthful, also youngthly, youthly, youthy [adj]"
youthy	"(scots) young, also youngthly, youthly, youthsome [adj youthier, youthiest]"
yow	"to howl, also yowl [v -ed, -ing, -s]"
yowe	(scots) a ewe [n -s]
yowed	"yow, to howl, also yowl [v]"
yowes	"yowe, (scots) a ewe [n]"
yowie	(native australian) a tall apelike monster of se australia [n -s]
yowies	"yowie, (native australian) a tall apelike monster of se australia [n]"
yowing	"yow, to howl, also yowl [v]"
yowl	"to howl, esp. of a wolf, also yow [v -ed, -ing, -s]"
yowled	"yowl, to howl, esp. of a wolf, also yow [v]"
yowler	one who yowls [n -s]
yowlers	"yowler, one who yowls [n]"
yowley	"the yellowhammer, also yeldring, yeldrock, yoldring, yorling [n -s]"
yowleys	"yowley, the yellowhammer, also yeldring, yeldrock, yoldring, yorling [n]"
yowling	the act or sound of yowling [n -s]
yowlings	"yowling, the act or sound of yowling [n]"
yowls	"yowl, to howl, esp. of a wolf, also yow [v]"
yows	"yow, to howl, also yowl [v]"
yperite	mustard gas [n -s]
yperites	"yperite, mustard gas [n]"
ypight	"pitch, to throw [v]"
yplast	"place, to assign to a position [v]"
yplight	"plight, to make a solemn pledge [v]"
ypsiliform	shaped like an ypsilon [adj]
ypsiloid	shaped like an upsilon [adj]
ypsilon	"(greek) the twentieth letter of the greek alphabet, also upsilon [n -s]"
ypsilons	"ypsilon, (greek) the twentieth letter of the greek alphabet, also upsilon [n]"
yrapt	(spenser) rapt [adj]
yravished	"ravish, to seize and carry off by force [v]"
yrent	"rend, to tear apart forcibly [v]"
yrivd	"rive, to tear apart [v]"
yrneh	a unit of reciprocal inductance [n -s]
yrnehs	"yrneh, a unit of reciprocal inductance [n]"
ysame	(spenser) together [adj]
yshend	"(spenser) to scold, also shend [v yshent, yshending, yshends]"
yshending	"yshend, (spenser) to scold, also shend [v]"
yshends	"yshend, (spenser) to scold, also shend [v]"
yshent	"yshend, (spenser) to scold, also shend [v]"
yslaked	"slake, to quench [v]"
ythundered	(spenser) struck by a thunderbolt [adj]
ytost	"toss, to throw lightly [v]"
ytterbia	"a chemical compound, ytterbium oxide [n -s]"
ytterbias	"ytterbia, a chemical compound, ytterbium oxide [n]"
ytterbic	"pertaining to, or derived from, ytterbium [adj]"
ytterbite	the mineral gadolinite [n -s]
ytterbites	"ytterbite, the mineral gadolinite [n]"
ytterbium	(swedish) a rare element of the boron group [n -s]
ytterbiums	"ytterbium, (swedish) a rare element of the boron group [n]"
ytterbous	containing ytterbium [adj]
yttria	"a chemical compound, the oxide of yttrium [n -s]"
yttrias	"yttria, a chemical compound, the oxide of yttrium [n]"
yttric	"(swedish) pertaining to, derived from, or containing, yttrium [adj]"
yttriferous	"(swedish) of an ore, bearing yttrium [adj]"
yttrious	"pertaining to, derived from, or containing, yttrium [adj]"
yttrium	a rare earth element [n -s]
yttriums	"yttrium, a rare earth element [n]"
yu	(chinese) a precious jade [n -s]
yuan	(chinese) a chinese monetary unit [n -s]
yuans	"yuan, (chinese) a chinese monetary unit [n]"
yuca	"a mexican plant of the lily family, also yucca [n -s]"
yucas	"yuca, a mexican plant of the lily family, also yucca [n]"
yucca	"a mexican plant of the lily family, also yuca [n -s]"
yuccas	"yucca, a mexican plant of the lily family, also yuca [n]"
yucch	"an interjection expressing disgust, also yecch, yech, yuch [interj]"
yuch	"an interjection expressing disgust, also yecch, yech, yucch [interj]"
yuck	"to laugh loudly, also yock, yok, yuk [v -ed, -ing, -s]"
yucked	"yuck, to laugh loudly, also yock, yok, yuk [v]"
yucker	"an american bird, the flicker or golden-winged woodpecker [n -s]"
yuckers	"yucker, an american bird, the flicker or golden-winged woodpecker [n]"
yuckier	"yucky, messy or disgusting [adj]"
yuckiest	"yucky, messy or disgusting [adj]"
yuckiness	the state of being yucky [n -es]
yuckinesses	"yuckiness, the state of being yucky [n]"
yucking	"yuck, to laugh loudly, also yock, yok, yuk [v]"
yucko	(australian slang) unpleasant [adj]
yucks	"yuck, to laugh loudly, also yock, yok, yuk [v]"
yucky	"messy or disgusting [adj yuckier, yuckiest]"
yuft	(russian) a kind of russian leather [n -s]
yufts	"yuft, (russian) a kind of russian leather [n]"
yug	"(sanskrit) one of the four hindu ages of the world, also yuga [n -s]"
yuga	"(sanskrit) one of the four hindu ages of the world, also yug [n -s]"
yugarie	"(native australian) any of various pipi shellfishes, also eugarie [n -s]"
yugaries	"yugarie, (native australian) any of various pipi shellfishes, also eugarie [n]"
yugas	"yuga, (sanskrit) one of the four hindu ages of the world, also yug [n]"
yugs	"yug, (sanskrit) one of the four hindu ages of the world, also yuga [n]"
yuk	"to laugh loudly, also yock, yok, yuck [v yukked, yukking, yuks]"
yukata	(japanese) a kind of light kimono [n -s]
yukatas	"yukata, (japanese) a kind of light kimono [n]"
yuke	"(dialect) to itch, also euk, ewk, yeuk, youk [v yuked, yuking, yukes]"
yuked	"yuke, (dialect) to itch, also euk, ewk, yeuk, youk [v]"
yukes	"yuke, (dialect) to itch, also euk, ewk, yeuk, youk [v]"
yukier	"yuky, itchy [adj]"
yukiest	"yuky, itchy [adj]"
yuking	"yuke, (dialect) to itch, also euk, ewk, yeuk, youk [v]"
yukked	"yuk, to laugh loudly, also yock, yok, yuck [v]"
yukkier	"yukky, disgusting, also yeuky, yucko, yucky, yuky [adj]"
yukkiest	"yukky, disgusting, also yeuky, yucko, yucky, yuky [adj]"
yukking	"yuk, to laugh loudly, also yock, yok, yuck [v]"
yukky	"disgusting, also yeuky, yucko, yucky, yuky [adj yukkier, yukkiest]"
yuko	"(japanese) in judo, a points penalty [n -s]"
yukos	"yuko, (japanese) in judo, a points penalty [n]"
yuks	"yuk, to laugh loudly, also yock, yok, yuck [v]"
yuky	"itchy [adj yukier, yukiest]"
yulan	"(chinese) a kind of magnolia, producing large white flowers [n -s]"
yulans	"yulan, (chinese) a kind of magnolia, producing large white flowers [n]"
yule	"christmas or christmastide, also yuletide [n -s]"
yules	"yule, christmas or christmastide, also yuletide [n]"
yuletide	"christmas or christmastide, also yuletide [n -s]"
yuletides	"yuletide, christmas or christmastide, also yuletide [n]"
yum	an interjection expressing satisfaction [interj]
yumberries	"yumberry, the purple-red edible fruit of an east asian tree [n]"
yumberry	the purple-red edible fruit of an east asian tree [n yumberries]
yummier	"yummy, delicious [adj]"
yummies	"yummy, something delicious [n]"
yummiest	"yummy, delicious [adj]"
yumminess	the quality of being yummy [n -es]
yumminesses	"yumminess, the quality of being yummy [n]"
yummo	(australian slang) delicious [adj]
yummy	"delicious [adj yummier, yummiest] / something delicious [n yummies]"
yump	"to become air-borne in a vehicle [v -ed, -ing, -s]"
yumped	"yump, to become air-borne in a vehicle [v]"
yumpie	"a young, upwardly, mobile person [n -s]"
yumpies	"yumpie, a young, upwardly, mobile person [n]"
yumping	"yump, to become air-borne in a vehicle [v]"
yumps	"yump, to become air-borne in a vehicle [v]"
yunx	"the wryneck, also jynx [n -es]"
yunxes	"yunx, the wryneck, also jynx [n]"
yup	"(colloquial) yes, also yep [n -s]"
yupon	"a bushy evergreen shrub of the holly genus, also yapon, yaupon, youpon [n -s]"
yupons	"yupon, a bushy evergreen shrub of the holly genus, also yapon, yaupon, youpon [n]"
yuppie	"a young professional person working in the city, also yuppy [n -s]"
yuppiedom	"the state of being a yuppie, also yuppydom [n -s]"
yuppiedoms	"yuppiedom, the state of being a yuppie, also yuppydom [n]"
yuppieish	like a yuppie [adj]
yuppies	"yuppie, a young professional person working in the city, also yuppy [n]"
yuppification	the process of conversion into a yuppy [n -s]
yuppifications	"yuppification, the process of conversion into a yuppy [n]"
yuppified	"yuppify, to infuse with the qualities or values of yuppies [v]"
yuppifies	"yuppify, to infuse with the qualities or values of yuppies [v]"
yuppify	"to infuse with the qualities or values of yuppies [v yuppified, yuppifying, yuppifies]"
yuppifying	"yuppify, to infuse with the qualities or values of yuppies [v]"
yuppy	"a young professional person working in the city, also yuppie [n yuppies]"
yuppydom	"the state of being a yuppie, also yuppiedom [n -s]"
yuppydoms	"yuppydom, the state of being a yuppie, also yuppiedom [n]"
yups	"yup, (colloquial) yes, also yep [n]"
yupster	a hipster with a professional job who seeks to climb the corporate ladder while remaining true to his ideals [n -s]
yupsters	"yupster, a hipster with a professional job who seeks to climb the corporate ladder while remaining true to his ideals [n]"
yurt	"(russian) a mongolian felt tent, also yourt, yurta [n -s]"
yurta	"(russian) a mongolian felt tent, also yourt, yurt [n -s]"
yurtas	"yurta, (russian) a mongolian felt tent, also yourt, yurt [n]"
yurts	"yurt, (russian) a mongolian felt tent, also yourt, yurta [n]"
yus	"yu, (chinese) a precious jade [n]"
yutz	(yiddish) a socially inept person [n -es]
yutzes	"yutz, (yiddish) a socially inept person [n]"
yuzu	(japanese) a type of citrus fruit [n -s]
yuzus	"yuzu, (japanese) a type of citrus fruit [n]"
ywis	"(archaic) certainly, also iwis [n]"
ywroke	"wreak, to effect, bring about [v]"